w w w w w
w P - - w
w - - - w
w - b o w
w - b o w
w - - - w
w - - - w
w - - - w
w - - - w
w w w w w